NO ./textures/brick.xpm
SO ./textures/stone.xpm
WE ./textures/grass.xpm
EA ./textures/wood.xpm
S ./textures/pillar.xpm
R     1440   +980
F 120,55,55
C    25,50,120


1111111
     1111111111111111111111111
     100000000011000000000001
     1001000000000222220000001
     1011000111000222220000001                  1 
      101100011000222220000E001
       1001000000000000000000001
        1111111111111111111111011
                 1111        101
         1111111111111111111110111
 111111111011000001110000000000001
 100000000011000001110111111111111
 11110111111111011100000000001
 11110111111111011100000010001
 11110111111111011101010010001
 11000000110101011100000010001
 10000100000000001100000010001
 10000000000000000001010010001
 1100000111010101111101111000111
 11110111 1110101 101111010001
 11111111 1111111 11111111111
